20
20
MMMMMMMMMMMMMMMMMMMM
MTTTTTTTTTTTTTTTTTTM
MTTRTTTTTTTTTTTTTTTM
MTTRTTTTTTTTTTTTTTTM
MTTRTTTTTTTTTTTTTTTM
MTTRTTTTTTTTTTTTTTTM
MTTTTTTTTTHTTTTTTTTM
MTTTTTTTTTTTTTTTTTTM
MTTTTTTTTTTTTTTTTTTM
MTTTTTTTTTTTTTTTTTTM
MTTTTTTTTTTTTTTTTTTM
MTTTTTTTTTTTTTTTTTTM
MTTTTTTTTTTTTTTTTTTM
MTTTTTMTTMRTRMTTTTTM
MTTTTTMTTMTTTMTTTTTM
MTTTTTMTTMRTRMTTTTTM
MTTTTTMTTMTTTMTTTTTM
MTTTTTMTEMRTRMTTTTTM
MTTTTDMTTMTDTMTTTTTM
MMMMMMMMMMMMMMMMMMMM