MMMMMMMMMMMMMMMMMMMM
MHTTTTTTTTTTTTTTTTTM
MRRRRRTTTTTTTTTTTTTM
MTTRTTTTTTTTTTTTTTTM
MTTRTTTTTTTTTTTTTTTM
MTTRTTTTTTTTTTTTTTTM
MTTRTTTTTTTTTTTTTTTM
MTTTTTTTTTTTTTTTTTTM
MTTTTTTTTTTTTTTTTTTM
MTTTTTTTTTTTTTTTTTTM
MTTTTTTTTTTTTTTTTTTM
MTTTTTTTTTTTTTTTTTTM
MTTTTTTTTTTTTTTTTTTM
MTTTTTTTTTTTTTTTTTTM
MTTTTTMTTMRTRMTTTTTM
MTTTTTMTTMTTTMTTTTTM
MTTTTTMTTMRTRMTTTTTM
MTTTTTMTTMTTTMTTTTTM
MTTTTTMTEMRTRMTTTTTM
MTTTTDMTTMTDTMTTTTTM
MMMMMMMMMMMMMMMMMMMM