MMMMMMMMMMMMMMMMMMMM
MTTTTTTTTTTTTTTTTTTM
MTHTTDTTTTTTTTTTTTTM
MTTTTTTTTTTTTTTTTTTM
MTTDTTTTTDRTTTTTRTTM
MTTTTTTTTTTTTTTTTTTM
MTTTTTTTTTTTTTTTTTTM
MTTTTTTDTTTTDTTTTTTM
MTTTTDTDTTTTRTTTTTTM
MTTTTRTTTTTRRTTTTTTM
MTTTTTTTTTTTTTTTTTDM
MTTTTTDTTTTTTTTTTTTM
MTTTTTRTTTTTTTTTTTTM
MTTTTTTTTTTTTTTTTTTM
MTTTTTTTDTTTDRTTRTTM
MTTDDTTTRTTTTTTTTTTM
MTTRRTTTTTDTTTTTTTTM
MTTRRTTTTTRTTTTTTTTM
MTTRRTTTTTRTTTTTTDTM
MTTRRTTTTTRTTTTTTTTM
MTTTTTTTDTRTTTTTDTTM
MTTTTTTTRTTTTTTTRTTM
MMMMMMMMMMMMMMMMMMMM